OOOOOOOOOO
OD       O
O  OOO   O
O        O
OOOOO  OOO
O        O
O  OOOOO O
O        O
O    O  AO
OOOOOOOOOO
