20 20
D    OOOO   O     O 
OO  O   OO OO O   O 
 OO O    O  O  O OO 
   O  OO    O O     
 O      O  OO     O 
O    O O  O  O  OOO 
O O  O O     O OO  O
  OOOO OOO  O O    O
  O  O     OO    O O
  O  O    O     OO O
  OO  O  OO  O OO   
  O   OOOO OO OO    
  O        OO O   O 
 O O         O   O  
  O OO OOOOOOO  OO  
 O   O         OO   
  O   O  OO    O  OO
  OO  O   OOOOO OO  
O  OO  OO     O OO  
O       OOOOOO     A
